128
12
0 0 0 0 0 0 0 0 0 0 1 2 0 0 0 0 0 0 0 0 0 0 0 0 0 0 0 0 0 0 0 0 0 0 0 0 0 0 0 0 0 0 0 0 0 0 0 0 0 0 0 0 0 0 0 0 0 0 0 0 0 0 0 0 0 0 0 0 0 0 0 0 0 0 0 0 0 0 0 0 0 0 0 0 0 0 0 0 0 0 0 0 0 0 0 0 0 0 0 0 0 0 0 0 0 0 0 0 0 0 0 0 0 0 0 0 0 0 0 0 0 0 0 0 0 0 3 4
0 0 0 0 0 0 0 0 0 5 6 7 0 0 0 0 0 0 0 0 0 0 0 0 0 0 8 8 8 0 0 0 0 0 1 2 0 0 0 0 8 0 0 0 1 2 0 0 0 0 0 0 0 8 8 8 0 0 0 0 0 0 0 0 0 0 1 2 0 0 0 0 0 0 0 0 0 8 9 10 0 0 0 0 0 0 0 0 0 0 0 0 0 0 8 0 8 0 0 0 0 0 0 0 0 0 0 0 0 0 0 0 0 0 0 0 0 0 0 0 1 2 0 0 0 0 3 4
0 1 2 0 0 0 0 0 0 0 0 0 0 0 0 0 0 0 0 0 0 0 0 0 0 0 11 11 11 0 0 0 0 5 6 7 0 12 13 14 15 16 0 5 6 7 0 0 0 0 0 0 0 11 11 11 0 0 0 0 0 0 0 0 0 5 6 7 0 0 0 0 0 0 0 0 17 18 0 0 0 0 0 8 8 8 0 0 0 0 0 1 2 0 19 12 20 0 1 2 0 0 0 0 0 0 0 12 16 0 9 10 0 0 0 0 0 0 0 5 6 7 0 0 0 0 3 4
5 6 7 0 0 0 0 0 0 0 0 0 0 0 0 0 9 10 0 0 0 8 8 8 0 0 1 2 0 0 0 0 0 0 0 0 0 21 22 23 24 25 0 0 0 0 0 0 8 8 8 0 0 0 0 0 1 2 0 0 0 0 0 0 0 0 0 0 0 0 0 0 0 12 13 13 21 26 0 0 0 0 0 11 11 11 12 13 13 16 5 6 7 0 19 27 26 28 29 30 0 0 0 0 0 0 0 27 26 0 0 0 0 0 0 0 0 0 8 8 8 0 0 0 0 0 3 4
0 0 0 0 0 9 10 0 0 0 0 0 0 0 0 0 0 0 0 0 0 11 11 31 13 32 6 7 0 0 0 0 0 0 0 0 3 33 34 35 0 0 0 0 0 0 12 16 11 11 11 0 0 0 0 5 6 7 0 0 0 0 0 0 0 0 0 0 0 0 0 0 0 36 24 22 22 37 0 0 0 0 0 0 0 0 36 24 24 25 0 0 0 0 19 36 38 33 34 35 0 0 0 9 10 0 0 27 26 0 0 0 0 0 0 0 0 0 11 11 11 0 0 0 9 10 3 4
0 0 0 0 39 39 39 39 39 0 0 0 0 0 0 0 0 0 0 0 0 0 3 40 41 42 13 13 16 0 0 0 0 0 0 0 0 0 0 0 0 0 0 0 0 0 27 43 13 44 10 0 0 12 16 0 0 0 12 16 45 0 0 8 0 0 0 0 0 0 0 0 1 2 3 33 34 35 0 0 0 0 0 0 0 9 10 0 13 13 46 0 0 0 19 0 0 0 0 0 0 0 0 0 0 0 0 36 25 0 0 13 13 46 0 0 0 0 0 0 12 47 48 0 0 0 3 4
49 13 13 50 51 51 51 51 52 53 0 0 0 12 13 13 13 16 0 0 0 0 0 36 24 24 24 24 25 0 0 0 0 0 0 13 13 46 0 0 0 9 10 0 0 0 27 54 34 35 0 0 0 27 26 0 0 0 27 55 56 0 12 57 13 13 13 16 0 0 0 5 6 7 0 0 0 0 0 0 0 0 0 0 0 0 13 58 59 34 35 0 0 0 19 0 0 0 0 0 0 0 1 2 0 0 0 0 0 0 3 33 34 35 0 0 1 2 0 0 36 60 61 0 0 0 3 4
62 63 63 63 63 63 63 63 64 65 0 0 0 36 24 24 24 25 0 0 0 0 0 0 0 0 0 0 0 0 0 0 0 0 3 33 34 35 0 12 13 16 0 0 0 0 27 43 13 13 16 0 0 27 26 0 0 0 36 24 25 0 36 24 24 24 24 25 0 0 0 0 0 0 0 0 0 0 12 13 16 0 0 0 0 3 33 34 35 0 0 0 0 0 19 12 16 0 0 0 0 5 6 7 0 0 0 0 0 0 12 13 13 16 0 5 6 7 0 0 0 66 67 68 13 69 3 4
70 71 71 71 71 71 71 71 72 73 0 0 0 0 0 0 0 0 0 0 0 0 0 0 0 0 0 0 0 0 9 10 0 0 0 0 0 0 0 36 24 25 0 0 0 0 36 24 24 24 25 0 0 27 43 13 16 0 0 0 0 0 0 0 0 0 0 0 13 13 46 0 12 13 13 13 16 0 36 24 25 0 0 1 2 0 0 0 0 0 0 0 0 0 19 27 26 0 0 0 0 0 0 0 0 0 0 0 0 13 21 23 24 25 0 0 0 0 0 0 0 66 74 75 64 65 3 4
70 71 71 71 71 71 71 71 72 73 0 0 0 0 1 2 0 0 0 0 0 0 0 9 10 0 0 0 0 0 0 0 0 0 0 0 0 0 0 13 13 46 0 0 0 0 0 0 0 0 1 2 0 36 24 24 25 9 10 12 13 13 13 16 0 0 0 3 33 34 35 0 36 24 24 24 25 0 0 0 0 0 5 6 7 0 0 0 0 9 10 0 0 0 11 27 43 13 13 16 0 0 0 0 0 0 0 0 3 33 34 35 0 0 0 0 0 0 0 0 13 76 77 78 79 80 58 4
70 71 71 71 71 71 71 71 72 73 0 0 0 5 6 7 0 0 0 0 0 0 0 0 0 0 0 0 0 0 0 0 0 0 0 0 0 0 3 33 34 35 0 0 0 0 0 0 0 5 6 7 0 0 0 0 0 0 0 36 24 24 24 25 0 0 0 0 0 0 0 0 9 10 0 0 0 0 0 0 0 0 0 0 0 0 0 0 0 0 0 0 0 0 0 36 24 24 24 25 0 0 0 0 0 0 0 9 10 0 0 0 13 13 46 0 0 0 0 27 81 82 82 82 82 82 82 83
84 85 85 85 85 85 85 85 79 80 13 13 13 13 13 13 13 13 13 13 13 13 13 13 13 13 13 13 13 13 13 13 13 13 13 13 13 13 13 13 13 13 13 13 13 13 13 13 13 13 13 13 13 13 13 13 13 13 13 13 13 13 13 13 13 13 13 13 13 13 13 13 13 13 13 13 13 13 13 13 13 13 13 13 13 13 13 13 13 13 13 13 13 13 13 13 13 13 13 13 13 13 13 13 13 13 13 13 13 13 13 58 86 41 42 13 13 13 13 58 87 88 88 88 88 88 88 89