0   0   0   0   0   0   0   0   0   0   0   0   0   0   0   0   0   0   0   0   0   0   0   0   0   0   0   0   0   0   0   0   0   0   0   0   0   0   0   0   0   0   0   0   0   0   0   0   0   0   0   0   0   0   0   0   0   0   0   0   0   0   0   0   0   0   0   0   0   0   0   0   0   0   0   0   0   0   0   0   0   0   0   0   0   0   0   0   0   0   0   0   0   0   0   0   0   0   0   0
0   0   0   0   0   0   0   0   0   0   0   0   0   0   0   0   0   0   0   0   0   0   0   0   0   0   0   0   0   0   0   0   0   0   0   0   0   0   0   0   0   0   0   0   0   0   0   0   0   0   0   0   0   0   0   0   0   0   0   0   0   0   0   0   0   0   0   0   0   56   0   0   0   0   0   0   0   0   0   0   0   0   0   0   0   0   0   0   0   0   0   0   0   0   0   0   0   0   0   0
0   0   0   0   0   0   0   0   0   0   0   0   0   0   0   0   0   0   0   0   0   0   0   0   0   0   0   0   0   0   0   0   0   0   0   0   0   0   0   0   0   0   0   0   0   0   0   0   0   0   0   0   0   0   0   0   0   0   0   0   0   0   0   0   0   0   0   0   0   0   0   0   0   0   0   0   0   0   0   0   0   0   0   0   0   0   0   0   0   0   0   0   0   0   0   0   0   0   0   0
0   0   0   0   0   0   0   0   0   0   0   0   0   0   0   0   0   0   0   0   0   0   0   0   0   0   0   0   0   0   0   0   0   0   0   0   0   0   0   0   0   0   0   0   0   0   0   0   0   0   0   0   0   0   0   0   0   0   0   0   0   0   0   0   0   0   0   56   0   0   0   0   0   0   0   0   0   0   0   0   0   0   0   0   0   0   0   0   0   0   0   0   0   0   0   0   0   0   0   0
0   0   0   0   0   0   0   0   0   0   0   0  19  19   0   0   0   0   0   0   0   0   0   0   0   0   0   0   0   0  42  43  43  44   0   0   0   0   0   0   0   0   0   0   0   0   0   0   0   0   0   0   0   0   0   0   0   0   0   0   0   0   0   0   0   0   0   0   0   0   0   0   0   0   0   0   0   0   0   0   0   0   0   0   0   0   0   0   0   0   0   0   0   0   0   0   0   0   0   0
0   0   0   0   0   0   0   0   0   0   0   0   0   0   0   0   0   0   0   0   0   0   0   0  19   0   0   0   0   0  45  46  46  47   0   0   0   0   0   0   0   0   0   0   0   0   0   0   0   0   0   0   0   0   0   0   0   0   0   0   0   0   0   0   0  56   0   0   0   0   0   0   0   0   0   0   0   0   0   0  20  21  21  21  21  21  22   0   0   0   0   0   0   0   0   0   0   0   0   0
0   0   0   0   0   0   0   0   0   0   0   0   0   0   0  20  21  22   0   0   0   0   0   0   0   0   0  10  11  11  12  46  46  47   0   0   0   0   0   0   0   0   0   0   0   0   0   0   0   0   0   0   0   3   4   0   0   0   0   0   0   0   0   0   0   0   0   0   0   0   0   0   0   0   0   0   0   0   0   0  23  24  24  24  24  24  25   0   0   0   0  55  55   0   0   0   0   0   0   0
0   3   4   0   0   0   0   0   0  19  19   0   0   0   0  23  24  25   0   0   0   0   0   0   0   0   0  13  14  14  15  46  46  47   0   0   0   0   0   0   0  19   0   0   0   0   0   0   0   0   3   4   3   6   5   3   4   0   3   4   0   0   0   0   0   0   0   0   0   0   0   0   0   0   0   0   0   0  10  11  11  11  11  11  12  24  25   0   0   0   0   0   0   0   0   0   0   0   0   0
3   6   5   3   4   3   4   0   0   0   0   0   0  10  11  12  24  25   0   0  29   30  0  33  34  34  34  35  14  14  15  46  46  47   0   0   0   0   0   0   0   0   0   0   0   0   0   0   0   0   2   7   6   7   6   8   5   0   2   7   4   0   0   0   0   0   0   0   0   0   0   0   0   0   0   0   0   0  13  14  14  14  14  14  15  24  25   0   0  19   0   0   0   0   0   0   0  55   0   0
2   7   6   8   5   2   7   4   0   0   0   0   0  13  14  15  24  25   0   0  31   32  0  36  37  37  37  38  14  14  33  34  34  34  34  35   0   0  19   9   9   9   9   9   9   0   0   0   0   3   6   8   8   8   8   8   5   3   6   8   5   0   0   9   9   0   0   0   0   0   0   0   0   0   0   0  33  34  34  34  34  34  35  14  15  24  25   0   0   0   0   0   0   0   0   0  55  55   0   0
2   8   8   8   7   6   8   5   0   9   9   0   0  16  17  18  27  28   0   0  31   32  0  39  40  40  40  41  14  14  39  40  40  40  40  41   0  51  52  51  52  51  52  51  52  51  52  51  52  51  52  51  52  51  52  51  52  51  52  51  52  51  52  51  52  51   0   0   0   0   0   9   9   9   0   0  39  40  40  40  40  40  41  17  18  27  28   0   0   0   0   0   0   0   0  55  55  55   0   0
1   1   1   1   1   1   1   1   1   1   1   1   1   1   1   1   1   1   1   1   1   1   1   1   1   1   1   1   1   1   1   1   1   1   1   1   1  53  54  53  54  53  54  53  54  53  54  53  54  53  54  53  54  53  54  53  54  53  54  53  54  53  54  53  54  53   0   0   0   1   1   1   1   1   1   1   1   1   1   1   1   1   1   1   1   1   1   1   1   1   1   0   0   1   1   1   1   1   0   0