33
13
0 1 1 1 1 1 1 1 2 3 4 1 1 1 1 1 1 1 1 1 1 1 2 3 4 1 1 1 1 1 1 1 5
6 7 7 7 7 7 7 7 8 9 10 11 11 11 11 11 11 11 11 11 11 11 12 9 13 7 7 7 7 7 7 7 14
6 7 7 7 7 7 7 7 15 16 17 18 18 18 19 19 18 18 18 18 18 18 20 21 22 7 7 7 7 7 7 7 14
6 7 7 7 7 7 7 7 23 18 18 18 18 19 24 24 19 18 18 18 18 18 18 18 25 7 7 7 7 7 7 7 14
6 7 7 7 7 7 7 7 23 18 18 18 18 24 18 18 26 18 18 18 18 27 28 28 29 7 7 7 7 7 7 7 14
6 7 7 7 7 7 7 7 23 18 18 18 18 18 19 19 24 18 18 18 27 29 7 7 7 7 7 7 7 7 7 7 14
6 7 7 7 7 7 7 7 23 18 18 18 18 18 24 24 19 18 18 27 29 7 7 7 7 7 7 7 7 7 7 7 14
6 7 7 7 7 7 7 7 23 18 18 18 18 19 18 18 26 18 27 29 7 7 7 7 7 7 7 7 7 7 7 7 14
6 7 7 7 7 7 7 7 23 18 18 18 18 24 19 19 24 27 29 7 7 7 7 7 7 7 7 7 7 7 7 7 14
6 7 7 7 7 7 7 7 23 18 18 18 18 18 24 24 27 29 7 7 7 7 7 7 7 7 7 7 7 7 7 7 14
6 7 7 7 7 7 7 7 30 28 28 28 28 28 28 28 29 7 7 7 7 7 7 7 7 7 7 7 7 7 7 7 14
6 7 7 7 7 7 7 7 7 7 7 7 7 7 7 7 7 7 7 7 7 7 7 7 7 7 7 7 7 7 7 7 14
31 32 32 32 32 32 32 32 32 32 32 32 32 32 32 32 32 32 32 32 32 32 32 32 32 32 32 32 32 32 32 32 33